{
  "map" : [
    "_","_","_","_","_","_","_","_","_","_","_","_","_","_","_","_","_","_","_","_","_","_","_","_","_","_","_","_","_","_",
    "_","_","_","_","_","_","_","_","_","_","_","_","_","_","_","_","_","_","_","_","_","_","_","_","_","_","_","_","_","_",
    "_","_","_","_","_","_","_","_","_","_","_","_","_","_","_","_","_","_","_","_","_","_","_","_","_","_","_","_","_","_",
    "_","_","_","_","_","_","_","_","_","_","_","_","_","_","_","_","_","_","_","_","_","_","_","_","_","_","_","_","_","_",
    "_","_","_","_","_","_","_","_","_","_","_","_","_","_","_","_","_","_","_","_","_","_","_","_","_","_","_","_","_","_",
    "_","_","_","_","_","_","_","_","_","_","_","_","_","_","_","_","_","_","_","_","_","_","_","_","_","_","_","_","_","_",
    "_","_","_","_","_","_","_","_","_","_","_","_","_","_","_","_","_","_","_","_","_","_","_","_","_","_","_","_","_","_",
    "_","_","_","_","_","_","_","_","_","_","_","_","_","_","_","_","_","_","_","_","_","_","_","_","_","_","_","_","_","_",
    "_","_","_","_","_","_","_","_","_","_","_","_","_","_","_","_","_","_","_","_","_","_","_","_","_","_","_","_","_","_",
    "_","_","_","_","_","▊","▊","▊","▊","▊","▊","▊","▊","▊","▊","▊","▊","▊","▊","▊","▊","▊","▊","_","_","_","_","_","_","_",
    "_","_","_","_","_","▊","_","T","_","▊","_","_","_","_","_","▊","_","_","_","_","_","_","▊","_","_","_","_","_","_","_",
    "_","_","_","_","_","▊","T","KR","_","DG","B","_","_","_","_","▊","_","_","W","_","_","_","▊","_","_","_","_","_","_","_",
    "_","_","_","_","_","▊","_","T","_","▊","X","_","_","_","_","DC","_","_","_","_","_","_","▊","_","_","_","_","_","_","_",
    "_","_","_","_","_","▊","▊","▊","▊","▊","X","_","_","_","_","▊","_","_","_","_","_","_","▊","_","_","_","_","_","_","_",
    "_","_","_","_","_","▊","_","T","_","▊","X","_","_","_","_","▊","▊","▊","▊","▊","▊","▊","▊","_","_","_","_","_","_","_",
    "_","_","_","_","_","▊","T","_","_","DR","X","_","_","_","_","_","_","_","_","_","_","_","▊","_","_","_","_","_","_","_",
    "_","_","_","_","_","▊","_","T","_","▊","X","_","_","_","_","_","_","_","_","_","_","_","▊","_","_","_","_","_","_","_",
    "_","_","_","_","_","▊","▊","▊","▊","▊","X","_","_","_","_","KG","_","_","_","_","_","_","▊","_","_","_","_","_","_","_",
    "_","_","_","_","_","▊","_","T","_","_","X","_","_","_","_","I","P","_","_","_","_","_","▊","_","_","_","_","_","_","_",
    "_","_","_","_","_","▊","T","T","T","_","X","_","_","_","_","_","_","_","_","_","_","_","▊","_","_","_","_","_","_","_",
    "_","_","_","_","_","▊","_","T","_","_","_","_","_","_","_","_","_","_","_","_","_","_","▊","_","_","_","_","_","_","_",
    "_","_","_","_","_","▊","▊","▊","▊","▊","▊","▊","▊","▊","▊","▊","▊","▊","▊","▊","▊","▊","▊","_","_","_","_","_","_","_",
    "_","_","_","_","_","_","_","_","_","_","_","_","_","_","_","_","_","_","_","_","_","_","_","_","_","_","_","_","_","_",
    "_","_","_","_","_","_","_","_","_","_","_","_","_","_","_","_","_","_","_","_","_","_","_","_","_","_","_","_","_","_",
    "_","_","_","_","_","_","_","_","_","_","_","_","_","_","_","_","_","_","_","_","_","_","_","_","_","_","_","_","_","_",
    "_","_","_","_","_","_","_","_","_","_","_","_","_","_","_","_","_","_","_","_","_","_","_","_","_","_","_","_","_","_",
    "_","_","_","_","_","_","_","_","_","_","_","_","_","_","_","_","_","_","_","_","_","_","_","_","_","_","_","_","_","_",
    "_","_","_","_","_","_","_","_","_","_","_","_","_","_","_","_","_","_","_","_","_","_","_","_","_","_","_","_","_","_",
    "_","_","_","_","_","_","_","_","_","_","_","_","_","_","_","_","_","_","_","_","_","_","_","_","_","_","_","_","_","_",
    "_","_","_","_","_","_","_","_","_","_","_","_","_","_","_","_","_","_","_","_","_","_","_","_","_","_","_","_","_","_"
  ]
}

