{
 "map" : [
  "_","_","_","_","_","_","_","_","_","_","_","_","_","_","_","_","_","_","_","_","_","_","_","_","_","_","_","_","_","_",
  "_","_","_","_","_","_","_","_","_","_","_","_","_","_","_","_","_","_","_","_","_","_","_","_","_","_","_","_","_","_",
  "_","_","_","_","_","_","_","_","_","_","_","_","_","_","_","_","_","_","_","_","_","_","_","_","_","_","_","_","_","_",
  "_","_","_","_","_","_","_","_","_","_","_","_","_","_","_","_","_","_","_","_","_","_","_","_","_","_","_","_","_","_",
  "_","_","_","_","_","_","_","_","_","_","_","_","_","_","_","_","_","_","_","_","_","_","_","_","_","_","_","_","_","_",
  "_","_","_","_","_","_","_","_","_","_","_","_","_","_","_","_","_","_","_","_","_","_","_","_","_","_","_","_","_","_",
  "_","_","_","_","_","_","_","_","_","_","_","_","_","_","_","_","_","_","_","_","_","_","_","_","_","_","_","_","_","_",
  "_","_","_","_","_","_","_","_","_","_","_","_","_","_","_","_","_","_","_","_","_","_","_","_","_","_","_","_","_","_",
  "_","_","_","_","_","▊","▊","▊","▊","▊","▊","▊","▊","▊","▊","▊","▊","▊","▊","▊","▊","▊","▊","_","_","_","_","_","_","_",
  "_","_","_","_","_","▊","_","_","_","_","_","_","_","_","_","▊","_","_","_","_","_","_","▊","_","_","_","_","_","_","_",
  "_","_","_","_","_","▊","_","_","_","_","_","_","_","I","_","▊","_","_","_","_","_","_","▊","_","_","_","_","_","_","_",
  "_","_","_","_","_","▊","_","_","_","_","_","_","_","P","_","▊","_","_","KG","T","_","_","▊","_","_","_","_","_","_","_",
  "_","_","_","_","_","▊","_","_","_","_","_","_","KR","_","_","DR","_","_","_","_","_","_","▊","_","_","_","_","_","_","_",
  "_","_","_","_","_","▊","_","_","_","_","_","_","_","_","_","▊","_","_","_","_","_","_","▊","_","_","_","_","_","_","_",
  "_","_","_","_","_","▊","_","_","_","_","_","_","_","_","_","▊","▊","▊","▊","▊","▊","▊","▊","_","_","_","_","_","_","_",
  "_","_","_","_","_","▊","▊","▊","DG","▊","_","_","_","_","_","_","_","_","_","_","_","_","▊","_","_","_","_","_","_","_",
  "_","_","_","_","_","▊","_","_","_","▊","_","_","_","_","_","_","_","_","_","_","_","_","▊","_","_","_","_","_","_","_",
  "_","_","_","_","_","▊","_","_","_","▊","_","_","_","_","_","_","_","_","_","_","_","_","▊","_","_","_","_","_","_","_",
  "_","_","_","_","_","▊","_","T","T","▊","_","_","_","_","_","_","_","_","_","_","_","_","▊","_","_","_","_","_","_","_",
  "_","_","_","_","_","▊","DC","▊","T","▊","_","_","_","_","_","_","_","_","_","_","_","_","▊","_","_","_","_","_","_","_",
  "_","_","_","_","_","▊","W","▊","_","▊","_","_","_","_","_","_","_","_","_","_","_","_","▊","_","_","_","_","_","_","_",
  "_","_","_","_","_","▊","▊","▊","▊","▊","▊","▊","▊","▊","▊","▊","▊","▊","▊","▊","▊","▊","▊","_","_","_","_","_","_","_",
  "_","_","_","_","_","_","_","_","_","_","_","_","_","_","_","_","_","_","_","_","_","_","_","_","_","_","_","_","_","_",
  "_","_","_","_","_","_","_","_","_","_","_","_","_","_","_","_","_","_","_","_","_","_","_","_","_","_","_","_","_","_",
  "_","_","_","_","_","_","_","_","_","_","_","_","_","_","_","_","_","_","_","_","_","_","_","_","_","_","_","_","_","_",
  "_","_","_","_","_","_","_","_","_","_","_","_","_","_","_","_","_","_","_","_","_","_","_","_","_","_","_","_","_","_",
  "_","_","_","_","_","_","_","_","_","_","_","_","_","_","_","_","_","_","_","_","_","_","_","_","_","_","_","_","_","_",
  "_","_","_","_","_","_","_","_","_","_","_","_","_","_","_","_","_","_","_","_","_","_","_","_","_","_","_","_","_","_",
  "_","_","_","_","_","_","_","_","_","_","_","_","_","_","_","_","_","_","_","_","_","_","_","_","_","_","_","_","_","_",
  "_","_","_","_","_","_","_","_","_","_","_","_","_","_","_","_","_","_","_","_","_","_","_","_","_","_","_","_","_","_"
 ]
}