{
  "map" : [
    "_","_","_","_","_","_","_","_","_","_","_","_","_","_","_","_","_","_","_","_","_","_","_","_","_","_","_","_","_","_",
    "_","_","_","_","_","_","_","_","_","_","_","_","_","_","_","_","_","_","_","_","_","_","_","_","_","_","_","_","_","_",
    "_","_","_","_","_","_","_","_","_","_","_","_","_","_","_","_","_","_","_","_","_","_","_","_","_","_","_","_","_","_",
    "_","_","_","_","_","_","_","_","_","_","_","_","_","_","_","_","_","_","_","_","_","_","_","_","_","_","_","_","_","_",
    "_","_","_","_","_","_","_","_","_","_","_","_","_","_","_","_","_","_","_","_","_","_","_","_","_","_","_","_","_","_",
    "_","_","_","_","_","_","_","_","_","_","_","_","_","_","_","_","_","_","_","_","_","_","_","_","_","_","_","_","_","_",
    "_","_","_","_","_","_","_","_","_","_","_","_","_","_","_","_","_","_","_","_","_","_","_","_","_","_","_","_","_","_",
    "_","_","_","_","_","_","_","_","_","_","_","_","_","_","_","_","_","_","_","_","_","_","_","_","_","_","_","_","_","_",
    "_","_","_","_","_","_","_","_","_","_","_","_","_","_","_","_","_","_","_","_","_","_","_","_","_","_","_","_","_","_",
    "_","_","_","_","_","▊","▊","▊","▊","▊","▊","▊","▊","▊","▊","▊","▊","▊","▊","▊","▊","▊","▊","_","_","_","_","_","_","_",
    "_","_","_","_","_","▊","_","T","_","▊","_","_","_","_","_","▊","_","_","_","_","_","_","▊","_","_","_","_","_","_","_",
    "_","_","_","_","_","▊","T","KR","_","DG","_","_","_","P","_","▊","_","_","W","_","_","_","▊","_","_","_","_","_","_","_",
    "_","_","_","_","_","▊","_","T","_","▊","_","_","_","_","_","DC","_","_","_","_","_","_","▊","_","_","_","_","_","_","_",
    "_","_","_","_","_","▊","▊","▊","▊","▊","_","_","_","_","_","▊","_","_","_","_","_","_","▊","_","_","_","_","_","_","_",
    "_","_","_","_","_","▊","_","T","_","▊","_","_","_","_","_","▊","▊","▊","▊","▊","▊","▊","▊","_","_","_","_","_","_","_",
    "_","_","_","_","_","▊","T","KB","_","DR","_","_","_","_","_","_","_","_","_","_","_","_","▊","_","_","_","_","_","_","_",
    "_","_","_","_","_","▊","_","T","_","▊","_","_","_","_","_","_","_","_","_","_","_","_","▊","_","_","_","_","_","_","_",
    "_","_","_","_","_","▊","▊","▊","▊","▊","_","_","_","_","_","KG","_","_","_","_","_","_","▊","_","_","_","_","_","_","_",
    "_","_","_","_","_","▊","_","T","_","▊","_","_","_","_","_","_","P","_","_","_","_","_","▊","_","_","_","_","_","_","_",
    "_","_","_","_","_","▊","T","T","T","DB","_","_","_","_","_","_","_","_","_","_","_","_","▊","_","_","_","_","_","_","_",
    "_","_","_","_","_","▊","_","T","_","▊","_","_","_","_","_","_","_","_","_","_","_","_","▊","_","_","_","_","_","_","_",
    "_","_","_","_","_","▊","▊","▊","▊","▊","▊","▊","▊","▊","▊","▊","▊","▊","▊","▊","▊","▊","▊","_","_","_","_","_","_","_",
    "_","_","_","_","_","_","_","_","_","_","_","_","_","_","_","_","_","_","_","_","_","_","_","_","_","_","_","_","_","_",
    "_","_","_","_","_","_","_","_","_","_","_","_","_","_","_","_","_","_","_","_","_","_","_","_","_","_","_","_","_","_",
    "_","_","_","_","_","_","_","_","_","_","_","_","_","_","_","_","_","_","_","_","_","_","_","_","_","_","_","_","_","_",
    "_","_","_","_","_","_","_","_","_","_","_","_","_","_","_","_","_","_","_","_","_","_","_","_","_","_","_","_","_","_",
    "_","_","_","_","_","_","_","_","_","_","_","_","_","_","_","_","_","_","_","_","_","_","_","_","_","_","_","_","_","_",
    "_","_","_","_","_","_","_","_","_","_","_","_","_","_","_","_","_","_","_","_","_","_","_","_","_","_","_","_","_","_",
    "_","_","_","_","_","_","_","_","_","_","_","_","_","_","_","_","_","_","_","_","_","_","_","_","_","_","_","_","_","_",
    "_","_","_","_","_","_","_","_","_","_","_","_","_","_","_","_","_","_","_","_","_","_","_","_","_","_","_","_","_","_"
  ]
}

